############
#          #
# # ###### #
# # # ###  #
# #        #
# ##### ####
# ##E      #
#  #########
##   #######
#### #######
####S#######
############
############