########
#      #
# # ## #
# #E## #
# #### #
# S  # #
########